NO ./textures/path_to_north_texture.png
SO ./textures/path_to_south_texture.png
WE ./textures/path_to_west_texture.png
EA ./textures/path_to_east_texture.png

FF165,90,0
C 127,127,255

        1111111111111111111111111
        10N0000000110000000000001
        1011000001110000000000001
        1001000000000000000000001
111111111011000001110000000000001
100000000011000001110111111111111
11110111111111011100000010001
11110111111111011101010010001
11000000110101011100000010001
10000000000000011000000100001
10000000000000000000000000001
1100000111010101111101111000111
11110111 1110101 101111010001
11111111 1111111 111111111111

