NO ./textures/path_to_north_texture.png
SO ./textures/path_to_south_texture.png
WE ./textures/path_to_west_texture.png
EA ./textures/path_to_east_texture.png

F 165,90,42
C 127,127,255

        1111111111111111111111111
        1000000000110000000000001
        1011000001110000000000001
        1001000000000000000000001
11111111101100N001110000000000001
100000000011000001110111111111111
11110111111111011100000010001
11110111111111011101010010001
11000000110101011100000010001
1000000000000001100000010001
10000000000000001101010010001
1100000111010101111101111000111
11110111 1110101 101111010001
11111111 1111111 111111111111
